1 11
550 550
1100 100 100 600 1100 100 10 600 0 1
1100 700 100 100 1010 700 100 10 -1 0
1000 200 100 600 1000 110 10 600 0 -1
1000 100 100 100 910 100 100 10 -1 0
900 100 100 600 900 100 10 600 0 1
300 700 700 100 210 700 700 10 -1 0
200 200 100 600 200 110 10 600 0 -1
200 100 100 100 110 100 100 10 -1 0
100 100 100 600 100 100 10 600 0 1
100 700 100 100 10 700 100 10 -1 0
0 100 100 700 0 100 10 700 0 -1
1100 100
50 110