3 5
300 300
600 300
500 600
100 150 900 100 100 150 900 5 1 0
1000 150 100 300 1000 150 5 300 0 1
200 450 900 100 105 450 900 5 -1 0
100 450 100 250 100 450 5 250 0 1
100 700 1000 100 100 700 1000 5 1 0
100 150
1000 750