1 8
550 400
100 100 1100 100 10 100 1100 10 -1 0
0 100 100 600 0 100 10 600 0 1
0 700 1100 100 0 700 1100 10 1 0
1100 400 100 400 1100 310 10 400 0 -1
400 300 800 100 310 300 800 10 -1 0
300 300 100 200 300 300 10 200 0 1
300 500 500 100 300 500 500 10 1 0
800 400  100 200 800 400 10 200 0 -1
1100 100
850 420