5 11
600 200
100 400
600 400
600 600
1100 400
800 300 400 100 710 300 400 10 -1 0
700 200 100 200 700 110 10 200 0 -1
600 100 200 100 510 100 200 10 -1 0
500 100 100 200 500 100 10 200 0 1
100 300 500 100 10 300 500 5 -1 0
0 300 100 200 0 300 10 200 0 1
0 500 500 100 0 500 500 10 1 0
500 500 100 200 500 500 10 200 0 1
500 700 200 100 500 700 200 10 1 0
700 600 100 200 700 510 10 200 0 -1
700 500 500 100 700 500 500 10 1 0
1100 300
1200 550  