3 6
450 150
850 450
250 700
100 150 300 100 105 150 300 5 -1 0
100 250 100 200 100 150 5 200 0 1
200 350 900 100 100 350 900 5 1 0
1000 450 100 200 1000 350 5 200 0 1
100 550 900 100 105 550 900 5 -1 0
100 650 100 150 100 550 5 250 0 1 
300 150
150 800
