5 8
200 650
200 350 
650 250
550 650
950 550
0 200 100 600 0 200 8 710 0 1
100 200 400 100 0 200 408 8 -1 0
400 300 100 200 400 200 8 208 0 -1
500 400 300 100 400 400 308 8 -1 0
700 500 100 300 700 400 8 308 0 -1
800 700 400 100 700 700 408 8 -1 0
1100 200 100 500 1100 200 8 508 0 1
1100 200 100 100 1100 200 1000 8 -1 0
1100 200
50 750