3 5
1000 250
200 400
1000 550
100 100 1100 100 10 100 1100 10 -1 0
0 100 100 600 0 100 10 600 0 1
0 700 1100 100 0 700 1100 5 1 0
1100 500 100 300 1100 410 10 300 0 -1
400 400 800 100 400 400 800 10 -1 0
1100 100
400 450